 ####### ### ######### ########### ### #
#.......#...#.........#...........#...#@#
#.#.###.#.#.#######.#.#.#.#######.#.#.#.#
#.#...#...#...#...#.#.#.#.#.....#...#.#.#
 ####.#######.#.#.#.###.#.#####.#####.#.#
#.....#.......#.#.#...#.#.#...#...#...#.#
#.#####.#######.#.###.#.#.#.#.###.#.###.#
#.#.....#.......#...#...#...#...#...#...#
#.#####.#.#########.###.#### ##.#.#####.#
#.#...#...#.......#...#.....#...#.#...#.#
#.#.#.#####.#.###.###.#######.###.#.#.#.#
#...#.#...#.#...#...#...#.....#.....#...#
 ####.#.#.#.###.###.###.#.#####.#### ##.#
#.#...#.#.....#...#...#.#...#...#...#...#
#.#.#########.###.#####.###.###.#.#.###.#
#.#.........#...#.#.......#...#.#.#...#.#
#.#########.#####.#.#####.###.###.###.#.#
#.......#...#.....#.#...#...#.....#...#.#
#.#.#.###.###.#####.#.#.###.#.#####.####
#.#.#.#...#.......#.#.#...#.#.....#.....#
#.#.#.#.#######.#.#.## ##.#.###.#######.#
#.#.#.#.......#.#.....#...#.#...#.......#
#.#.#.#######.#########.###.#####.#####.#
#.#.#...#...#...........#.#.....#.#.#...#
 ##.#####.#.#############.#####.#.#.#.##
#...#...#.#.......#.#.......#...#.#...#.#
#.###.#.#.#.#####.#.#.#.#.###.###.#.###.#
#...#.#...#...#.....#.#.#.#...#...#...#.#
#.#.#.#######.#######.#.#.#.###.## ##.#.#
#.#...#.....#.........#.#.#.....#.#...#.#
#.#########.###########.#.#######.#.###.#
#.........#.........#...#.#.....#.#.#...#
 ########.#.#####.#.#.## ##.#.#.#.#.#.##
#...#.....#.#.....#.#...#...#.#...#.#...#
#.###.#####.#.#####.###.#.###.#.###.###.#
#.#...#...#.#.#.....#.#...#.#.#.#...#...#
#.#.###.#.###.#.#####.#####.#.###.###.#.#
#.#.#...#...#.#.#.......#...#...#.#...#.#
#.#.#.#####.#.#.#####.#.#.#.###.#.###.#.#
#.....#.......#.......#...#...#.......#.#
 ##### ####### ####### ### ### ####### #